34 34 34 34 34 34 34 34 34 34 34 34 34 34 34 34 34 34 34 34 34 34 34 34 34 34 34 34 34 34 34 34 34 34 34 34 34 34 34 34 34 34 34 34 34 34 34 34 34 34
34 34 34 34 34 34 34 43 34 34 34 34 34 34 34 34 34 34 34 34 34 43 34 34 34 34 34 34 43 34 34 34 34 34 34 34 34 43 34 34 34 34 34 34 34 34 34 34 43 34
34 34 34 34 43 34 34 34 34 34 34 34 34 43 34 34 34 34 34 34 34 34 34 34 34 34 34 34 34 34 34 34 34 34 34 34 34 34 34 34 43 34 34 43 34 34 34 34 34 34
34 34 34 34 34 34 34 34 43 34 34 34 34 34 34 34 34 34 34 43 34 34 34 34 34 34 34 34 34 34 34 34 43 34 34 34 34 34 34 34 34 34 34 34 34 43 34 34 34 43
34 43 34 34 34 34 34 34 34 43 34 34 34 34 43 34 43 34 34 34 34 34 34 43 34 34 34 34 43 34 34 34 34 34 34 43 34 43 34 34 34 34 34 43 34 34 34 34 34 34
34 34 34 34 43 34 34 34 34 34 34 34 43 34 34 34 34 34 34 34 43 34 34 34 34 34 34 34 34 34 43 34 34 34 34 34 34 34 34 34 34 34 34 34 34 34 34 34 34 34
34 34 34 34 34 34 27 26 26 26 26 26 28 34 34 43 34 34 34 34 34 34 34 34 34 34 43 34 34 34 34 34 34 34 34 34 43 34 34 34 34 34 34 34 34 43 34 34 34 34
34 43 34 34 34 34 29 40 40 40 40 40 30 34 34 34 34 34 34 27 26 26 26 26 26 26 26 28 34 34 34 34 43 34 34 34 34 34 34 34 43 34 34 34 34 34 34 34 43 34
34 34 34 34 34 34 29 40 36 36 36 40 30 34 34 34 34 34 34 29 48 24 24 24 24 24 49 30 43 34 34 34 34 34 34 34 34 34 34 34 34 34 43 34 34 34 34 34 34 34
34 34 34 43 34 34 29 40 36 36 36 40 30 34 34 34 43 34 34 29 22 42 42 42 42 42 21 30 34 34 34 34 34 43 34 34 34 43 34 34 34 34 34 34 34 34 34 34 34 34
34 43 34 34 34 34 29 40 36 36 36 40 30 34 34 34 34 34 34 29 22 42 42 42 42 42 21 30 34 34 43 34 34 27 26 26 26 26 26 26 26 26 26 28 34 34 34 34 34 34
34 34 34 34 34 43 29 40 40 36 40 40 30 34 43 34 34 34 34 29 22 42 42 42 42 42 21 30 34 34 34 34 34 29 40 40 48 24 24 24 49 40 40 30 34 34 34 34 34 34
34 34 34 34 34 34 29 40 40 36 40 40 30 34 34 34 34 34 43 29 22 42 42 42 42 42 21 30 34 34 34 43 34 29 40 36 22 42 42 42 21 36 40 30 34 34 43 34 34 34
34 34 34 43 34 34 29 40 40 36 40 40 45 26 26 28 27 26 26 44 50 19 20 42 18 19 51 45 26 26 28 34 34 29 40 36 22 42 42 42 21 36 40 30 34 34 34 34 43 34
34 34 34 34 34 34 29 40 40 40 40 40 40 40 40 45 44 40 40 40 40 40 22 42 21 40 40 40 40 40 45 26 26 44 40 40 50 19 19 19 51 40 40 30 34 34 34 34 34 34
34 43 34 34 34 34 29 40 40 40 40 40 40 40 40 40 40 40 40 40 40 40 22 42 21 40 40 40 40 40 40 40 40 40 40 40 40 40 40 40 40 40 40 30 34 43 34 34 34 34
34 34 34 43 34 34 29 40 40 40 40 40 40 40 40 40 40 40 40 40 40 40 22 42 21 40 40 40 40 40 40 40 40 40 40 40 40 48 24 49 40 40 40 30 34 34 34 34 34 34
34 34 34 34 34 43 29 40 40 40 40 40 40 40 40 40 40 40 40 40 40 40 22 42 21 40 40 40 40 40 40 40 40 40 40 40 48 25 42 23 49 40 40 30 34 34 34 34 34 34
34 34 34 34 34 34 29 40 40 40 40 40 40 40 40 40 40 40 40 40 40 40 22 42 21 40 40 40 40 40 40 40 40 40 40 40 22 42 42 42 21 40 40 30 34 34 34 43 34 34
34 34 43 34 34 43 29 40 40 40 40 40 40 40 40 40 40 48 24 24 24 24 25 42 23 24 24 24 24 49 40 40 40 40 40 40 22 42 42 42 21 40 40 30 34 34 34 34 34 34
34 34 34 34 34 34 29 40 40 40 40 40 40 40 40 40 40 22 42 42 42 42 42 42 42 42 42 42 42 21 40 40 40 40 40 40 22 42 42 42 21 40 40 30 34 34 34 34 34 34
34 34 34 34 34 34 29 40 40 40 40 40 40 40 40 40 40 22 42 18 19 19 19 19 19 19 19 20 42 21 40 40 40 40 40 40 22 42 42 42 21 40 40 30 34 34 34 34 34 34
34 34 34 43 34 34 29 40 40 40 40 40 40 40 40 40 40 22 42 21 10 11 11 11 11 11 12 22 42 23 24 24 24 24 24 24 25 42 42 42 21 40 40 30 34 34 34 34 34 34
34 34 34 34 34 34 29 40 40 40 40 40 40 40 40 40 40 22 42 21 16 43 34 34 34 43 17 22 42 42 42 42 42 42 42 42 42 42 42 42 21 40 40 30 34 34 43 34 34 34
34 34 34 34 34 34 29 40 40 40 40 40 40 40 40 40 40 22 42 21 16 34 34 43 34 34 17 22 42 42 42 42 42 42 42 42 42 42 42 42 21 40 40 30 34 34 34 34 34 34
34 34 34 43 34 34 29 40 40 40 40 40 40 40 40 40 40 22 42 21 13 14 14 14 14 14 15 22 42 18 19 19 19 19 19 19 19 19 19 19 51 40 40 30 34 34 34 34 34 34
34 43 34 34 34 34 29 40 40 40 40 40 40 40 40 40 40 22 42 23 24 24 24 24 24 24 24 25 42 21 40 40 40 40 40 40 40 40 40 40 40 40 40 30 34 34 34 34 34 34
34 34 34 34 34 34 29 40 40 40 40 40 40 40 40 40 40 22 42 42 42 42 42 42 42 42 42 42 42 21 40 40 40 40 40 40 40 40 40 40 40 40 40 30 34 34 34 43 34 34
34 34 34 34 43 34 29 40 40 40 40 40 40 40 40 40 40 50 19 19 19 19 19 19 19 19 19 20 42 21 40 40 40 40 40 40 40 40 40 47 32 32 32 33 34 34 34 34 34 34
34 34 34 34 34 34 29 40 40 40 40 40 40 40 40 40 40 40 35 35 35 35 35 36 40 40 40 22 42 21 40 40 40 40 40 40 47 32 32 33 34 34 34 34 43 34 34 34 34 34
34 43 34 34 34 34 29 40 40 40 40 40 40 40 40 40 40 35 36 35 35 35 35 35 35 40 40 22 42 21 40 40 40 40 40 40 30 34 43 34 34 34 43 34 34 34 34 34 34 34
34 34 34 34 34 34 29 40 40 40 40 40 40 40 40 40 35 35 35 35 35 36 35 35 35 36 40 22 42 21 40 40 40 40 40 40 45 26 26 28 34 34 34 34 34 34 34 34 34 34
34 34 34 34 34 43 29 40 40 40 40 40 40 40 40 40 35 35 35 35 35 35 35 35 35 35 40 22 42 21 40 40 40 40 40 40 40 40 40 45 26 26 26 28 34 34 34 34 34 34
34 34 34 34 34 34 29 40 40 40 40 40 40 40 40 40 36 35 35 36 35 35 35 36 35 35 40 22 42 23 24 24 49 40 40 40 40 40 40 40 40 40 40 30 34 34 43 34 34 34
34 34 34 34 34 34 29 40 40 40 40 40 40 40 40 40 35 35 35 35 35 35 35 35 35 35 40 22 42 42 42 42 21 36 35 35 40 40 40 40 40 40 40 30 34 34 34 34 34 34
34 34 43 34 34 34 29 40 40 40 40 40 40 40 40 40 35 35 36 35 35 35 35 35 35 35 40 50 19 19 19 19 51 40 40 35 40 40 40 36 35 36 40 30 34 34 34 34 34 34
34 34 34 34 34 34 29 40 40 40 40 40 40 40 40 40 35 35 35 35 35 35 35 35 35 35 40 40 40 40 40 40 40 40 40 35 35 35 35 35 35 35 40 30 34 34 34 34 34 34
34 34 34 34 34 34 29 40 40 40 40 40 40 40 40 40 40 35 35 35 35 36 35 35 36 40 40 40 40 40 40 40 40 40 40 40 40 40 40 35 36 35 40 30 34 43 34 43 34 34
34 43 34 34 34 34 29 40 40 40 40 40 40 40 40 40 40 40 47 32 32 32 32 46 40 40 40 40 40 40 40 40 40 40 40 40 40 40 40 40 40 40 40 30 34 34 34 34 34 34
34 34 34 34 34 34 29 40 40 40 40 40 40 40 40 47 32 32 33 34 34 43 34 31 32 32 46 40 40 40 40 40 40 40 40 40 40 40 40 40 40 40 40 30 34 34 34 34 43 34
34 34 34 34 43 34 31 32 32 32 32 32 32 32 32 33 34 34 34 43 34 34 34 34 34 34 31 32 32 32 32 32 32 32 32 32 32 32 32 32 32 32 32 33 34 34 34 34 34 34
34 43 34 34 34 34 34 34 34 34 34 34 34 34 34 34 34 34 34 34 34 34 34 34 34 34 34 34 34 34 34 43 34 34 34 34 43 34 34 43 34 34 34 34 34 43 34 34 34 34
34 34 34 34 43 34 34 43 34 34 34 43 34 34 34 34 43 34 34 34 34 34 43 34 34 34 34 34 34 34 34 34 34 34 34 34 34 34 34 34 34 34 43 34 34 34 34 34 34 34
34 34 34 34 34 34 34 34 34 34 34 34 34 34 34 34 34 34 34 34 34 34 34 34 34 34 43 34 43 34 34 34 34 34 34 34 34 34 34 34 43 34 34 34 34 34 43 34 34 34
34 34 34 43 34 34 34 34 34 43 34 34 34 34 43 34 34 34 34 34 43 34 34 34 34 34 34 34 34 34 34 34 34 43 34 34 34 34 43 34 34 34 34 34 34 34 34 34 34 34
34 34 34 34 34 34 43 34 34 34 34 34 34 34 34 34 34 34 34 34 34 34 34 43 34 34 34 34 43 34 34 34 34 34 34 34 34 34 34 34 34 34 34 43 34 34 34 34 43 34
34 43 34 34 34 34 34 34 34 34 34 34 34 34 34 34 34 43 34 34 34 34 34 34 34 34 34 34 34 34 34 34 34 34 34 34 34 34 34 34 34 34 34 34 34 34 43 34 34 34
34 34 34 34 34 34 34 34 34 34 34 34 34 34 34 34 34 34 34 34 34 34 34 34 34 34 34 34 34 34 34 34 34 34 34 34 34 34 34 34 34 34 34 34 34 34 34 34 34 34