6 6 6 6 6 6 6 6 6 6 6 6 6 6 6 6 6 6 6 6 6 6 6 6 6 6 6 6 6 6 6 6 6 6 6 6 6 6 6 6 6 6 6 6 6 6 6 6 6 6
6 4 4 4 4 4 4 4 4 4 4 4 4 4 4 4 4 4 4 4 4 4 4 4 4 4 4 4 4 4 4 4 4 4 4 4 4 4 4 4 4 4 4 4 4 4 4 4 0 6
6 4 4 4 4 4 4 4 4 4 4 4 4 4 4 4 4 4 4 4 4 4 2 2 2 4 4 4 4 4 4 4 4 4 4 4 4 4 4 4 4 4 4 4 4 4 4 4 4 6
6 4 4 4 4 4 4 4 4 4 4 4 4 4 4 4 4 4 4 4 4 2 2 2 2 2 4 4 4 4 4 4 4 4 4 4 4 4 3 3 3 3 3 3 3 3 4 4 4 6
6 4 4 4 4 4 4 4 4 4 4 4 4 4 4 4 4 4 4 4 4 2 2 3 2 2 4 4 4 4 4 4 4 4 4 4 4 4 3 4 4 4 4 4 4 3 4 4 4 6
6 4 4 4 4 4 4 4 4 4 4 4 4 4 4 4 4 4 4 4 4 4 2 3 2 4 4 4 4 4 4 4 4 4 4 4 4 3 3 3 4 4 4 4 4 3 4 4 4 6
6 4 4 4 4 4 4 4 6 6 6 6 6 4 4 4 4 4 4 4 4 4 4 3 4 4 4 4 4 4 4 3 3 3 3 3 3 3 3 3 3 3 3 3 3 3 4 4 4 6
6 4 4 4 4 4 4 4 6 3 3 3 6 4 4 4 4 4 4 4 4 4 4 3 4 4 4 4 4 4 4 3 3 4 4 4 4 3 3 3 4 4 4 4 4 4 4 4 4 6
6 4 4 4 4 4 4 4 6 3 3 3 6 4 4 4 4 4 4 4 4 4 4 3 4 4 4 4 4 4 4 3 4 0 0 0 0 4 3 4 4 4 4 4 4 4 4 4 4 6
6 4 4 4 4 4 4 4 6 3 3 3 6 4 4 4 4 4 4 4 4 4 4 3 4 4 4 4 4 4 4 3 4 0 0 0 0 4 3 4 4 4 4 4 4 4 4 4 4 6
6 4 4 4 4 4 0 0 6 3 3 3 6 4 4 4 4 4 4 4 4 4 4 3 4 4 4 4 4 4 4 3 4 0 0 0 0 4 3 4 4 4 4 4 4 4 4 4 4 6
6 4 4 4 4 0 0 0 6 6 3 6 6 4 4 4 4 4 4 4 4 4 4 3 4 4 4 4 4 4 4 3 3 4 4 4 4 3 3 4 4 4 4 4 4 4 4 4 4 6
6 4 4 4 0 0 0 0 0 0 0 0 4 4 4 4 4 4 4 4 4 4 4 3 4 4 4 4 4 4 4 3 3 3 3 3 3 3 3 4 4 4 4 4 4 4 4 4 4 6
6 4 4 0 0 0 0 0 0 0 0 0 4 0 0 0 4 4 4 4 4 4 4 3 4 4 4 4 4 4 4 4 4 4 4 4 4 4 3 4 4 4 4 4 4 4 4 4 4 6
6 4 4 0 0 0 0 0 0 0 0 0 0 0 0 0 4 4 4 4 4 4 4 3 4 4 4 4 4 4 4 4 4 4 4 4 4 4 3 4 4 4 4 4 4 4 4 4 4 6
6 4 4 0 0 0 0 0 0 0 0 0 0 0 0 0 4 4 4 4 4 4 4 3 4 4 4 4 4 4 4 4 4 4 4 4 4 4 3 4 4 4 4 4 4 4 4 4 4 6
6 4 4 0 0 0 0 0 0 0 0 0 4 0 0 0 4 4 4 4 4 4 4 3 4 4 4 4 4 4 4 4 4 4 4 4 4 4 3 4 4 4 4 4 4 4 4 4 4 6
6 4 4 0 0 0 0 0 0 0 0 0 4 4 4 4 4 4 4 4 4 4 4 3 4 4 4 4 4 4 4 4 4 4 4 4 4 4 3 4 4 4 4 4 4 4 4 4 4 6
6 4 4 4 0 0 0 0 0 0 0 4 4 4 4 4 4 4 4 4 4 4 4 3 4 4 4 4 4 4 4 4 4 4 4 4 4 4 3 4 4 4 4 4 4 4 4 4 4 6
6 4 4 4 4 0 0 0 0 0 4 4 4 4 4 4 4 4 4 4 4 4 0 3 0 4 4 4 4 4 4 4 4 4 4 4 4 4 3 4 4 4 4 4 4 4 4 4 4 6
6 4 4 4 4 0 0 4 4 4 4 4 4 4 4 4 4 4 4 4 4 0 0 3 0 0 4 4 4 4 4 4 4 4 4 4 4 3 3 3 4 4 4 4 4 4 4 4 4 6
6 4 4 4 4 0 0 4 4 4 4 4 3 3 3 3 3 3 3 3 3 3 3 3 3 3 3 3 3 3 3 3 3 3 3 3 3 3 3 3 3 3 3 3 3 3 3 3 3 6
6 4 4 4 0 0 0 0 0 0 0 4 0 4 4 4 4 4 4 4 4 0 0 3 0 0 4 4 4 4 4 4 4 5 5 5 5 5 5 5 5 5 5 5 5 5 5 5 5 6
6 4 4 4 0 0 0 0 0 0 0 4 0 4 4 4 4 4 4 4 4 4 0 3 0 4 4 4 4 4 4 4 5 5 5 5 5 5 5 5 5 5 5 5 5 5 5 5 5 6
6 4 4 4 0 0 0 0 0 0 0 4 0 4 4 4 4 4 4 4 4 4 4 3 4 4 4 4 4 4 4 5 5 5 5 5 5 5 5 5 5 5 5 5 5 5 5 5 5 6
6 4 4 4 0 0 0 0 0 0 4 4 0 4 4 4 4 4 4 4 4 4 4 3 4 4 4 4 4 4 5 5 5 5 5 5 5 5 5 5 5 5 5 5 5 5 5 5 5 6
6 4 4 4 4 4 0 0 0 4 4 4 0 4 4 4 5 5 5 5 5 5 4 3 4 4 4 4 4 5 5 5 5 5 5 5 5 5 5 5 5 5 5 5 5 5 5 5 5 6
6 4 4 4 0 4 4 4 0 4 4 4 0 4 4 5 5 2 2 2 2 5 5 3 4 4 4 4 4 5 5 5 5 5 5 5 5 5 5 5 5 5 5 5 5 5 5 5 5 6
6 4 4 0 0 0 4 4 0 4 4 4 0 4 4 5 2 2 2 2 2 2 5 3 4 4 4 4 4 5 5 5 5 5 5 5 5 5 5 5 5 5 5 5 5 5 5 5 5 6
6 4 4 0 0 0 0 0 0 0 0 0 0 4 4 5 2 2 2 2 2 2 5 3 4 4 4 4 4 5 5 5 5 5 5 5 5 5 5 5 5 5 5 5 5 5 5 5 5 6
6 4 4 0 0 0 0 5 5 0 0 0 4 4 0 5 2 2 2 2 2 2 5 3 4 4 4 4 4 5 5 5 5 5 5 5 5 5 5 5 5 5 5 5 5 5 5 5 5 6
6 4 4 4 0 0 5 5 5 5 0 0 4 4 4 5 2 2 2 2 2 2 5 3 4 4 4 4 4 5 5 5 5 2 2 2 5 5 5 5 5 5 5 5 5 5 5 5 5 6
6 4 4 4 0 0 0 5 5 0 0 0 4 4 4 5 5 2 2 2 2 5 5 3 4 4 4 4 4 5 5 5 2 2 2 2 2 5 5 5 5 5 5 5 5 5 5 5 5 6
6 4 4 4 4 4 0 0 0 0 0 4 4 4 4 4 5 5 5 5 5 5 4 3 4 4 4 4 4 5 5 5 2 2 2 2 2 5 5 5 5 5 5 5 5 5 5 5 5 6
6 4 4 4 4 4 4 4 4 4 3 4 4 4 4 4 4 4 4 4 4 4 4 3 4 4 4 4 4 5 5 5 5 2 2 2 5 5 5 5 5 5 5 5 5 5 5 5 5 6
6 4 4 4 4 4 4 4 4 0 3 0 0 2 2 2 2 2 0 0 4 4 4 3 4 4 4 4 4 5 5 5 5 5 5 5 5 5 5 5 5 5 5 5 5 2 2 5 5 6
6 4 4 4 4 4 4 4 4 4 3 0 2 2 2 2 2 2 2 0 0 4 4 3 4 4 4 4 4 5 5 5 5 5 5 5 5 5 5 5 5 5 5 5 2 2 2 2 5 6
6 3 3 4 4 4 4 4 4 4 3 3 3 3 3 3 3 3 3 3 3 3 3 3 4 4 4 4 4 5 5 5 5 5 5 5 5 5 5 5 5 5 5 5 5 2 2 5 5 6
6 3 3 4 4 4 4 4 4 0 0 0 2 2 2 2 2 2 2 0 0 0 4 3 4 4 4 4 4 4 5 5 5 5 5 5 5 5 5 5 5 5 5 5 5 5 5 5 5 6
6 3 4 4 4 4 4 4 4 4 0 0 0 2 2 2 2 2 0 0 0 4 0 3 4 4 4 4 4 4 4 5 5 5 5 5 5 5 5 5 5 5 5 5 5 5 5 5 5 6
6 3 4 4 4 0 0 0 0 4 4 4 4 4 4 4 4 4 4 4 4 0 0 3 4 4 4 4 4 4 4 4 5 5 5 5 5 5 5 5 4 4 5 5 5 5 5 5 5 6
6 3 4 4 0 0 2 2 0 0 4 4 4 4 4 4 4 4 4 4 0 0 0 3 4 4 4 4 4 4 4 4 4 5 5 5 5 5 5 4 3 3 4 5 5 5 5 5 5 6
6 3 3 4 0 2 2 2 2 0 4 4 4 4 4 4 0 0 0 0 0 0 0 3 4 4 4 4 4 4 4 4 4 5 5 5 5 5 4 4 3 3 4 4 5 5 5 5 5 6
6 4 3 4 4 4 2 2 0 4 4 0 0 0 0 0 0 0 0 0 0 4 4 3 4 4 4 4 4 4 4 4 4 4 4 4 4 4 4 3 3 3 3 4 4 4 4 4 4 6
6 4 3 4 0 0 0 0 0 4 0 0 0 0 0 0 0 0 4 4 4 4 4 3 4 4 4 4 4 3 3 3 3 3 3 3 3 3 3 3 3 3 3 3 3 0 0 0 0 6
6 3 3 4 0 0 0 4 4 0 0 0 0 0 0 0 4 4 4 4 4 4 4 3 4 4 4 4 4 4 4 4 4 4 4 4 4 4 4 4 4 4 4 4 4 4 4 4 4 6
6 3 4 4 0 4 4 0 0 0 0 0 4 4 4 4 4 4 4 4 4 4 4 3 4 4 4 4 4 4 4 4 4 4 4 4 4 4 4 4 4 4 4 4 4 4 4 4 4 6
6 3 4 4 0 0 0 0 0 0 4 4 4 4 4 4 4 4 4 4 4 4 4 3 4 4 4 4 4 4 4 4 4 4 4 4 4 4 4 4 4 4 4 4 4 4 4 4 4 6
6 4 4 4 4 4 4 4 4 4 4 4 4 4 4 4 4 4 4 4 4 4 4 4 4 4 4 4 4 4 4 4 4 4 4 4 4 4 4 4 4 4 4 4 4 4 4 4 4 6
6 6 6 6 6 6 6 6 6 6 6 6 6 6 6 6 6 6 6 6 6 6 6 6 6 6 6 6 6 6 6 6 6 6 6 6 6 6 6 6 6 6 6 6 6 6 6 6 6 6